ID	Value
string	string
FamilyName	FirstName
赵	新之
钱	景辰
孙	宗汉
李	晓灵
周	正
吴	开平
郑	萧
王	楚然
冯	慕鸿
陈	箫柯
褚	少亭
卫	柏
蒋	钧成
沈	如南
韩	震山
杨	佳湉
朱	啸天
秦	骁
尤	少云
许	瀚
何	足道
吕	济民
施	平
张	汉儒
孔	方
曹	灏
严	翊苓
华	少荃
金	奎发
魏	有丁
陶	竣
姜	熙月
戚	嫣
谢	天笑
邹	肖宾
徐	霆云
苏	长卿
奚	文
范	清辉
马	秉文
花	锦
方	天彦
俞	昭云
任	承道
袁	沐
柳	东来
史	进
唐	延儒
岑	凌云
薛	川
雷	琨
汤	一墨
殷	文玄
罗	冲
邬	远山
安	思道
常	威
时	楚才
于	成骥
齐	恒轩
康	万
伍	少行
顾	士元
孟	常
穆	云
萧	震
尹	子昂
邵	鸣峰
汪	平
祁	子昱
狄	珩
成	庚山
戴	魁
宋	子义
庞	青云
司马	骅成
诸葛	成献
上官	伯骞
欧阳	林汉
皇甫	书奕
慕容	尚铭
司寇	步长
仲孙	朔
司徒	世坤
东郭	宗
宇文	定邦
钟离	庭元
叶	甫
班	仲景
白	凡宸
池	云逸
燕	岳清
国	天淳
弘	胜
丁	云野
邱	江汉
仇	浩然
裘	有贞
石	贤
牧	东阳
刘	一清
