ID	Key
string	string
Id	Key
Common_UpgradeResources	升级所需资源:
Common_BuildResources	建造所需资源:
Common_UpgradeInfoDesc	升级需要讲武堂达到
Common_BuildInfoDesc	建造需要讲武堂达到
Common_InfoDesc	需要讲武堂达到
Common_FulledLevel	已满级
Common_FullLevel	满级
Common_Upgrade	升级
Common_Build	建造
Common_NotBuild	尚未建造
Common_NotUnlocked	未解锁
Common_Unlocked	解锁
Common_UpgradeNeeds	升级需要:
Common_NextLevelUnlock	下一级解锁
Common_Reward	完成奖励
Common_Declined	婉拒
Common_GoTo	前往
Common_Popup_NeedLobby	讲武堂等级不够哦，先去升级讲武堂吧
Common_Popup_Materials	材料不足，再去找点来吧
Common_Popup_Coin	铜钱不够了，快去努力工作
Common_Unit_Grade	级
Common_Unit_People	人
Common_Unit_Day	天
Common_Unit_Part	段
Common_Unit_Class	阶
Common_Unit_Individual	个
Common_Unit_Only	第
Common_Unit_Layer	层
Common_Unit_TenThousand	万
Common_Number_Zero	零
Common_Number_One	一
Common_Number_Two	二
Common_Number_Three	三
Common_Number_Four	四
Common_Number_Five	五
Common_Number_Six	六
Common_Number_Seven	七
Common_Number_Eight	八
Common_Number_Nine	九
Common_Number_Ten	十
Facility_PracticeFieldEast_Name	东练功场
Facility_PracticeFieldWest_Name	西练功场
Facility_PracticeField_Describe	这是一个练功场
Facility_KongfuLibrary_Name	藏经阁
Facility_KongfuLibrary_Describe	这是一个藏经阁
Facility_Kitchen_Name	伙房
Facility_Kitchen_Describe	这是一个伙房
Facility_BaiCaoHu_Name	百草屋
Facility_BaiCaoHu_Describe	这是一个百草屋
Facility_ForgeHouse_Name	锻造屋
Facility_ForgeHouse_Describe	这是一个锻造屋
Facility_Lobby_GoldRecruitment	金牌招募令
Facility_Lobby_SilverRecruitment	银牌招募令
Facility_Lobby_PossibleRecruitment	可能招募:
Facility_Lobby_Apprentice	普通徒弟
Facility_Lobby_Elite	精英徒弟
Facility_Lobby_Genius	天才徒弟
Facility_Lobby_TimesToday	今日次数:
Facility_Lobby_Free	免费
Facility_Lobby_Recruit	招募
Facility_Lobby_CurCount	当前数量:
ClanType_Gaibang	丐帮
ClanType_Shaolin	少林
ClanType_Wudang	武当派
ClanType_Emei	峨眉山
ClanType_Huashan	华山
ClanType_Wudu	五毒教
ClanType_Mojiao	魔教
ClanType_Xiaoyao	逍遥派
ChallengeName	挑战
ChallengeDescribe	想要成为天下第一门派，必须要打败武林十大门派，等弟子们武功有所小成，便可择机挑战他们。
Challenge_Status_Completed	已完成
Challenge_Status_Unlocked	未解锁
Challenge_Log_Title	退出战斗
Challenge_Log_Content	战斗尚未结束，你真的要投降认输吗？
Challenge_Log_AcceptBtnTxt	打不过溜了
Challenge_Log_RefuseBtnTxt	继续干
Challenge_Progress	挑战进度
Challenge_Progress_Over	挑战进度：100%
Disciple_Name	弟子
Disciple_Describe	这是一个弟子界面
Disciple_Quality_Normal	平民级
Disciple_Quality_Good	精英级
Disciple_Quality_Perfect	天才级
Disciple_Title_Level	等级
Disciple_Title_Skill	功力
Disciple_Title_EntryTime	入门时间
Disciple_Title_Rank	段位
Disciple_State_Working	正在干活
Disciple_State_Free	空闲
Disciple_Practice	去练功
Disciple_Work	去干活
Disciple_Eject	逐出师门
Disciple_BtnValue_Normal	平民
Disciple_BtnValue_Good	精英
Disciple_BtnValue_Perfect	天才
Disciple_BtnValue_All	全部
Kungfu_Title	功夫
kungfu_State_NotLearned	尚未学习
kungfu_State_Learnable	可学习
Kungfu_Name_BasicBoxing	基本拳脚
Kungfu_Name_XLSBZ	降龙十八掌
Equip_Title_Skill	功力
Equip_Intensify	强化
Armor_title	铠甲
Armor_Name_MKJ	明铠甲
Arms_title	武器
Facility_Warehouse_Name	仓库
Facility_Warehouse_Describe	这是一个仓库
Facility_LivableRoomEast_Name	屋舍-东厢房
Facility_LivableRoomWest_Name	屋舍-西厢房
Facility_LivableRoom_Describe	这是一个屋舍
Facility_LivableRoom_CurrentlyHabitable	当前可居住:
Facility_LivableRoom_NextHabitable	下一级可居住:
ClickChallenge	点击挑战
StoryPanel_Text_1	在下闯荡江湖三十年，练就一身绝世武功，威震中原。
StoryPanel_Text_2	只是四处漂泊这么久，至今居无定所，独身一人。也该是时候独立门户，创建自己的门派了。
StoryPanel_Text_3	我看此地依山傍水，地势开阔，适合居住。前后又有山峦作为屏障，易守难攻，正是建立门派的好地方。
StoryPanel_Text_4	山前有座破庙，看起来荒废已久，不如打扫一番，做我们门派的讲武堂吧。
StoryPanel_Text_5	真不错，看起来有模有样。给我们门派起个名字吧。
StoryPanel_Text_6	接下来建造一些屋舍供弟子们居住。
StoryPanel_Text_7	大功告成，去招募一波弟子试试看!
StoryPanel_Text_8	点击建造
StoryPanel_Text_9	点击完成屋舍建造
StoryPanel_Text_10	点击讲武堂
StoryPanel_Text_11	点击发出招募令
StoryPanel_Text_12	糟糕，造屋舍耗光了木材，派我这徒儿去搜集一番吧。
StoryPanel_Text_13	点击查看任务
StoryPanel_Text_14	点击查看详情
StoryPanel_Text_15	点击派遣弟子执行任务
StoryPanel_Text_16	点击领取奖励
StoryPanel_Text_17	这徒弟傻头傻脑的，砍起木头来倒是一把好手，也算个可塑之才。
StoryPanel_Text_18	现在，我们继续建造屋舍来招募更多的弟子
StoryPanel_Text_19	点击完成建造
StoryPanel_Text_20	这小子骨骼清奇、虎虎生气，加以指点日后必成气候！
StoryPanel_Text_21	门派振兴需要更多的建造资源，再派两个弟子去挖一些石材回来。
StoryPanel_Text_22	点击公告榜
StoryPanel_Text_23	在这里可以选择执行此任务的弟子。
StoryPanel_Text_24	点击气泡快速领取奖励
StoryPanel_Text_25	弟子们饥肠辘辘，赶紧建一座伙房吧。
StoryPanel_Text_26	伙房是制作食物的场所，升级伙房可以提高食物上限，提高食物恢复速度。
StoryPanel_Text_27	门派的运转需要大家同心协力，派遣弟子去处理一些日常事务吧。
StoryPanel_Text_28	派遣弟子进行工作，可获得丰厚的金币奖励。
StoryPanel_Text_29	点击气泡可快速给弟子派活。
StoryPanel_Text_30	建造仓库来存放物资，如果你不再需要它们，甚至可以这在卖掉。
StoryPanel_Text_31	百草屋是研制草药的禅房，战斗中携带可提升功力，恢复血量，还能复活弟子。
StoryPanel_Text_32	练功场是弟子们练功升级的地方，新招募的低等级弟子在这里可以快速升级。
StoryPanel_Text_33	藏经阁里收藏着各门各派的武功秘籍，弟子们在这里抄写经书，获取武功秘籍。
StoryPanel_Text_34	在锻造屋打造铠甲和武器，武装你的弟子。
StoryPanel_Text_35	伙房升级！解锁烹饪功能，点击快炒试试看吧。
StoryPanel_Text_36	门派附近生长着各种各样的植物，点击它们来收集些资源吧。
StoryPanel_Text_37	去讲武堂来一发金牌招募令，有机会招揽到高级弟子。
StoryPanel_Text_38	点击选择
StoryPanel_Text_39	点击前往
StoryPanel_Text_40	可以根据进度条查看弟子工作进度。
StoryPanel_Text_41	掌门，山门外有贵客来访，快快迎接
StoryPanel_Text_42	点击访客按钮
StoryPanel_Text_43	点击接受收下知府大人的礼物吧
StoryPanel_Text_44	已经有弟子练功小成，是时候传授他武功了！
StoryPanel_Text_45	弟子经过这次锻炼，实力变强了！
StoryPanel_Text_46	弟子还可以在练功房中提升自己的实力。
StoryPanel_Text_47	弟子功法大成，作为师傅应该赠予弟子一把趁手的武器！
StoryPanel_Text_48	掌门，自派以来，徒儿们勤于练功而不辍，实力精进许多，是时候在江湖上打响我派的名号了！
StoryPanel_Text_49	先拿丐帮试试身手。
StoryPanel_Text_50	就从最弱的大仁分舵开始吧！
StoryPanel_Text_51	选取实力最强的弟子发起挑战！
StoryPanel_Text_52	出发！
StoryPanel_Text_53	门派振兴需要更多的建造资源，再派两个弟子去挖一些石材回来。
StoryPanel_Text_54	点击采集石材
StoryPanel_Text_55	不好！附近有恶狼徘徊，快派弟子前去清剿吧
StoryPanel_Text_56	如果掌门事务繁忙，弟子也会自动工作
StoryPanel_Text_57	新派初建，一片杂乱。俗话说：一屋不扫，何以扫天下
StoryPanel_Text_58	点击气泡，让弟子把讲武堂打扫干净
StoryPanel_Text_59	点击采集莲藕
StoryPanel_Text_60	点击打开弟子界面
StoryPanel_Text_61	点击目标弟子
StoryPanel_Text_62	选择秘籍传授给弟子吧
StoryPanel_Text_63	点击确认完成传授吧
StoryPanel_Text_64	点击安排
StoryPanel_Text_65	选择武器给弟子穿上吧
StoryPanel_Text_66	点击确认完成装备吧
StoryPanel_Text_67	点击武器槽
StoryPanel_Text_68	人是铁饭是钢，弟子干活太累需要补充食物
StoryPanel_Text_69	点击观看广告补充食物
StoryPanel_Text_70	什么？竟然有弟子在狼窝中捡到银牌招募令！
StoryPanel_Text_71	掌门，我们快去招募弟子吧！
StoryPanel_Text_72	讲武堂是招募弟子的场所
StoryPanel_Text_73	点击讲武堂
StoryPanel_Text_74	点击发出招募令
StoryPanel_Text_75	招募令是招募弟子的必须品，可以在战斗中或通过观看广告获取。
StoryPanel_Text_76	金牌招募令更有机会招来天才级弟子哦！
StoryPanel_Text_77	掌门，知府赵大人来访，为我派送来资源，助我派名扬武林！
StoryPanel_Text_78	点击打开签到界面
StoryPanel_Text_79	点击完成签到
StoryPanel_Text_80	知府大人每日都会遣人送来资源，掌门记得及时领取哦
StoryPanel_Text_81	江湖险恶，不仅有猛兽，更有贼人时常作乱！
StoryPanel_Text_82	掌门将他们赶走可以使一方安宁！
StoryPanel_Text_83	在镖局弟子可以押送镖车，赚取奖励，快派弟子开始吧。
StoryPanel_Text_84	点击进入镖局
StoryPanel_Text_85	来不及解释了，快开车！
StoryPanel_Text_86	观看广告加速运镖！
StoryPanel_Text_87	掌门，弟子实力提升光纸上谈兵可不行。
StoryPanel_Text_88	安排弟子前往伏魔塔，在危机中成长。
StoryPanel_Text_89	点击进入伏魔塔
StoryPanel_Text_90	伏魔塔中邪魔外道横行，弟子难有机会回复体力。
StoryPanel_Text_91	伏魔塔每日都会发生异变，请掌门谨慎安排
StoryPanel_Text_92	选取实力最强的弟子进行战斗
StoryPanel_Text_93	我们上！
StoryPanel_Text_94	伏魔币可以在这里兑换商品
StoryPanel_Text_95	前有邪魔，掌门快安排弟子挑战
StoryPanel_Text_96	天才弟子只要通过英雄试炼就能变得更强！
StoryPanel_Text_97	点击进入英雄试炼
StoryPanel_Text_98	每天会有一个门派主持试炼，今日由丐帮主持试炼
StoryPanel_Text_99	点击前往
StoryPanel_Text_100	选择弟子进行试炼
StoryPanel_Text_101	点击进入试炼
StoryPanel_Text_102	点击完成试炼
StoryPanel_Text_103	恭喜，弟子突破成功
StoryPanel_Text_104	恭喜掌门通关，伏魔塔明日会再次刷新，掌门继续挑战！
StoryPanel_Text_105	伏魔塔明日会再次刷新，掌门重新来过！
BulletinBoard_ViewDetails	查看
BulletinBoard_ReceiveRewards	领取
BulletinBoard_PutAway	收起
BulletinBoard_Recommended	推荐功力:
BulletinBoard_SelectedDisciple	选择弟子
BulletinBoard_SelectedDiscipleSkills	已选弟子功力:
BulletinBoard_NotArranged	未安排
BulletinBoard_Relaxed	轻松
BulletinBoard_Autious	谨慎
BulletinBoard_Danger	危险
BulletinBoard_NeedLevel	需要弟子等级:
BulletinBoard_Reward	领奖
